40 100
####################################################################################################
#                                                                                                  #
#                                                                                                  #
#                                                                                                  #
#                              *                                                                   #
#                            * *                                                                   #
#                  **      **            **                                                        #
#                 *   *    **            **                                                        #
#      **        *     *   **                                                                      #
#      **        *   * **    * *                                                                   #
#                *     *       *                                                                   #
#                 *   *                                                                            #
#                  **                                                                              #
#                                                                     **                           #
#                                                                      **                          #
#                                                                      *                           #
#                                                                                                  #
#                                                                                                  #
#                                                                                                  #
#                                                                                                  #
#                                                                                                  #
#                                                                                                  #
#                                                                                                  #
#                                                                                                  #
#                                                                                                  #
#                                                                                                  #
#                                                                                                  #
#                     *                                                                            #
#                   * **                                                                           #
#                   * *                                                                            #
#                   *                                                                              #
#                 *                                                                                #
#               * *                                                                                #
#                                                                                                  #
#                                                                                                  #
#                                                                                                  #
#                                                                                                  #
#                                                                                                  #
#                                                                                                  #
####################################################################################################